14 14 14 14 14 14 14 14 14 14
14 14 14 19 19 19 19 14 14 14
14 14 14 19 14 29 19 14 14 14
14 19 19 19 23 14 19 14 14 14
14 19 14 14 03 03 19 14 14 14
14 19 14 14 14 23 19 14 14 14
14 19 19 19 19 19 19 14 14 14
14 14 14 14 14 14 14 14 14 14
14 14 14 14 14 14 14 14 14 14
14 14 14 14 14 14 14 14 14 14