14 14 14 14 14 14 14 14 14 14
14 14 14 16 16 16 16 14 14 14
14 14 14 16 14 10 16 14 14 14
14 14 14 16 10 14 16 14 14 14
14 14 14 16 03 10 16 14 14 14
14 14 16 16 10 23 16 14 14 14
14 14 16 14 03 23 16 14 14 14
14 14 16 14 10 29 16 14 14 14
14 14 16 16 16 16 16 14 14 14
14 14 14 14 14 14 14 14 14 14