14 14 14 14 14 14 14 14 14 14
14 14 14 19 19 19 19 14 14 14
14 14 14 19 14 29 19 14 14 14
14 14 14 30 20 14 19 19 14 14
14 14 19 19 14 00 14 19 14 14
14 14 19 14 14 14 14 19 14 14
14 14 19 14 14 14 19 19 14 14
14 14 19 19 19 19 19 14 14 14
14 14 14 14 14 14 14 14 14 14
14 14 14 14 14 14 14 14 14 14